AHHHHHHHHHHHHHHHHHHHZ
VO   O   OVO   O   OV
V AHZ AHZ V AHZ AHZ V
V QHS QHS V QHS QHS V
VO        O        OV
V HHH V HHHHH V HHH V
VO    VO  V  OV    OV
VHHHZ VHH V HHV AHHHV
VHHHS V   O   V QHHHV
V     VOHHHHHOV     V
VOHHH           HHHOV
V     VOHHHHHOV     V
VHHHZ V   O   V AHHHV
VHHHS VHH V HHV QHHHV
VO    VO     OV    OV
V HHH V HHHHH V HHH V
VO        O        OV
V AHZ AHZ V AHZ AHZ V
V QHS QHS V QHS QHS V
VO   O   OVO   O   OV
QHHHHHHHHHHHHHHHHHHHS
