AHHHHHHHHHHHHHHHHHHHZ
V.........V.........V
V.AHZ.AHZ.V.AHZ.AHZ.V
V.QHS.QHS.V.QHS.QHS.V
V...................V
V.HHH.V.HHHHH.V.HHH.V
V.....V...V...V.....V
VHHHZ.VHH.V.HHV.AHHHV
VHHHS.V.......V.QHHHV
V.....V.AH.HZ.V.....V
VHHHH...VV.VV...HHHHV
V.....V.QHHHS.V.....V
VHHHZ.V...V...V.AHHHV
VHHHS.VHH...HHV.QHHHV
V.....V...V...V.....V
V.HHH.V.HHHHH.V.HHH.V
V...................V
V.AHZ.AHZ.V.AHZ.AHZ.V
V.QHS.QHS.V.QHS.QHS.V
V.........V.........V
QHHHHHHHHHHHHHHHHHHHS
